border_size=1
usage=map

Xu          , Xu          , Xu          , Xu          , Xu          , Xu          , Xu          , Xu          , Xu          , Xu          , Xu          , Xu          , Xu          , Qxu         , Qxu         , Urb         , Urb         , Urb         , Urb         , Urb         , Urb         , Xos         , Xol         , Xu          , Xu          , Xu          , Xu          , Xu          , Xu          , Xu          , Xu          , Xu          , Xu          , Xu          , Xu          , Xu          , Xu          , Xu          , Xu          
Xu          , Xu          , Xu          , Xu          , Xu          , Xu          , Xu          , Xu          , Xu          , Xu          , Xu          , Xu          , Xu          , Qxu         , Qxu         , Qxu         , Xu          , Urb         , Urb         , Urb         , Urb         , Urb         , Urb         , Xol         , Xos         , Xu          , Xu          , Xu          , Xu          , Xu          , Xu          , Xu          , Xu          , Xu          , Xu          , Xu          , Xu          , Xu          , Xu          
Xu          , Xu          , Xu          , Xu          , Xu          , Xu          , Xu          , Xu          , Xu          , Xu          , Xu          , Xu          , Xu          , Xu          , Xu          , Xu          , Xos         , Xu          , Xu          , Ur          , Ur          , Urb         , Urb         , Urb         , Ur          , Xos         , Xos         , Xu          , Xu          , Xu          , Xu          , Xu          , Xu          , Xu          , Xu          , Xu          , Xu          , Xu          , Xu          
Xu          , Xos         , Xos         , Xu          , Xos         , Xu          , Xu          , Xu          , Xu          , Xu          , Xu          , Xu          , Xu          , Xu          , Xu          , Xu          , Xu          , Xos         , Xos         , Xos         , Ur          , Urb         , Urb         , Urb         , Urb         , Xos         , Xos         , Xu          , Xu          , Xu          , Xu          , Xu          , Xu          , Xu          , Xu          , Xu          , Xu          , Xu          , Xu          
Xos         , Xos         , Xos         , Xos         , Xos         , Xos         , Xos         , Xu          , Xos         , Xu          , Xu          , Xu          , Xos         , Xu          , Xos         , Xu          , Xu          , Xu          , Xu          , Xos         , Urb         , Urb         , Urb         , Urb         , Urb         , Xos         , Xos         , Xu          , Xu          , Xu          , Xu          , Xu          , Xu          , Xu          , Xu          , Xu          , Xu          , Xu          , Xu          
Xos         , Xos         , Urb         , Ur          , Urb         , Xos         , Xos         , Xos         , Xol         , Xos         , Xol         , Xol         , Ur          , Xol         , Cud         , Xos         , Xos         , Xos         , Xos         , Xos         , Urb         , Urb         , Urb         , Urb         , Urb         , Xos         , Xu          , Xu          , Xu          , Xu          , Xos         , Xu          , Xos         , Xu          , Xu          , Xu          , Xu          , Xu          , Xu          
Xos         , Urb         , Urb         , Urb         , Urb^Ng/     , Xos         , Xol         , Xos         , Ur          , Ur          , Ql          , Ql          , Urb         , Urb         , Cud         , Cud         , 3 Kud       , Cud         , Xos         , Xos         , Xos         , Urb         , Urb         , Urb         , Xol         , Xos         , Xos         , Xos         , Xos         , Xos         , Xos         , Xos         , Xos         , Xos         , Xos         , Xu          , Xu          , Xu          , Xu          
Xu          , Xos         , Xos         , Xos         , Ur          , Urb         , Urb         , Xol         , Xos         , Urb         , Urb         , Urb         , Urb         , Urb         , Urb         , Cud         , Cud         , Cud         , Xos         , Xos         , Ur          , Ur^Ng\      , Xos         , Ur^Ng/      , Ur          , Xos         , Xos         , Xos         , Xos         , Xos         , Urb         , Xos         , Xos         , Xos         , Xos         , Xos         , Xos         , Xu          , Xu          
Xu          , Xos         , Urb         , Ur          , Urb         , Urb         , Urb         , Ur          , Ur          , Xos         , Urb         , Urb         , Urb         , Urb         , Urb^Bzl     , Urb         , Cud         , Qxu         , Xos         , Xos         , Urb         , Urb^Bzl     , Ur          , Urb^Bzl     , Urb         , Xos         , Xos         , Xos         , Urb         , Urb         , Urb         , Ur          , Xos         , Xos         , Ql          , Xos         , Xos         , Xu          , Xos         
Xos         , Xos         , Urb         , Urb         , Urb         , Urb         , Xos         , Ur          , Ur          , Urb         , Urb         , Urb         , Xol         , Xos         , Xos         , Cud         , Cud         , Qxu         , Xol         , Xos         , Urb         , Urb         , Ur          , Urb         , Urb         , Xos         , Xos         , Xos         , Urb         , Urb         , Ur          , Ur          , Xos         , Ql          , Xol         , Qxu         , Qxu         , Xos         , Xos         
Xos         , Xos         , Urb^Ng\     , Urb         , Xos         , Xos         , Xuc         , Xos         , Xos         , Urb         , Urb         , Urb         , Urb         , Xol         , Xos         , Cud         , Xos         , Xol         , Urb         , Urb         , Ur          , Ur          , Urb         , Urb         , Xos         , Xos         , Urb         , Xos         , Xos         , Urb         , Urb         , Xos         , Urb         , Ur          , Ur          , Xol         , Xos         , Ql          , Ql          
Ygl         , Ygl         , Ygl         , Xuc         , Xuc         , Xuc         , Uu^Nsh      , Xuc         , Xos         , Xos         , Urb         , Urb         , Urb         , Urb         , Xol         , Xol         , Cud         , Urb         , Urb         , Urb         , Urb         , Urb         , Xos         , Xos         , Xos         , Urb         , Urb         , Urb         , Urb         , Urb         , Urb         , Urb         , Urb         , Urb         , Xos         , Xos         , Xos         , Xos         , Qxu         
Ygl         , Ygl         , Xuc         , Xuc         , Uu          , Uu          , Xuc         , Uu^Dr       , Ur          , Ur          , Ur          , Urb         , Xol         , Xos         , Qxu         , Cud         , Cud         , Cud         , Cud         , Urb         , Xos         , Xos         , Xos         , Xos         , Xos         , Xos         , Xos         , Urb         , Urb         , Urb         , Urb         , Urb         , Urb         , Xos         , Xol         , Xol         , Qxu         , Qxu         , Xos         
Xuc         , Xuc         , Ql          , Xu          , Uu          , Xuc         , Xos         , Xos         , Urb         , Urb         , Xos         , Xol         , Qxu         , Qxu         , Ur          , Ur          , Qxu         , Cud         , Xos         , Xol         , Xos         , Xos         , Xos         , Xos         , Xos         , Xos         , Xos         , Urb         , Ur          , Urb         , Xos         , Urb         , Urb^Ng/     , Urb^Ng/     , Urb         , Urb         , Urb         , Xos         , Xos         
Xu          , Xu          , Ql          , Uu          , Qxu         , Qxu         , Qxu         , Xos         , Urb         , Urb         , Xos         , Qxu         , Urb         , Urb         , Qxu         , Qxu         , Xos         , Xos         , Xol         , Xol         , Cud         , Xos         , Cud         , Xos         , Xos         , Xos         , Xos         , Xos         , Xos         , Xos         , Urb         , Xos         , Urb         , Ur          , Urb         , Urb         , Urb         , Urb         , Xos         
Qlf         , Qlf         , Xu          , Ql          , Ql          , Ql          , Qlf         , Qlf         , Urb         , Ur          , Ur          , Urb^Ng\     , Urb^Ng\     , Qxu         , Xol         , Xos         , Ydc         , Ydc         , Cud         , Cud         , Cud         , 2 Kud       , Qxu         , Cud         , Xos         , Xos         , Xos         , Xos         , Xos         , Urb         , Urb         , Ur          , Ur          , Ur          , Ur          , Urb         , Cud         , Urb         , Xos         
Ql          , Xu          , Xu          , Xu          , Ql          , Ql          , Ql          , Qxu         , Qlf         , Ur          , Urb         , Urb         , Urb         , Xol         , Xol         , Xol         , Urb         , Ydc         , Cud         , Qxu         , Cud         , Cud         , Cud         , Cud         , Xos         , Xos         , Urb         , Xos         , Xos         , Urb         , Urb         , Ur          , Urb         , Ur          , Cud         , Urb^Bzn     , Kud         , Cud         , Xos         
Xu          , Xu          , Qxu         , Qlf         , Qxu         , Ql          , Xuc         , Qlf         , Xos         , Urb         , Urb         , Urb         , Urb         , Ur          , Ur          , Ur          , Ur          , Urb^Bzl     , Ydc         , Cud         , Xos         , Xos         , Xos         , Ur^Ng/      , Ur          , Urb         , Ur          , Urb         , Urb         , Xos         , Urb^Ng\     , Urb         , Xos         , Cud         , Qxu         , Cud         , Cud         , Cud         , Xos         
Qlf         , Xu          , Ql          , Qxu         , Qlf         , Xu          , Xu          , Xuc         , Xuc         , Xos         , Urb         , Urb         , Urb         , Urb         , Urb         , Urb         , Urb         , Urb         , Urb         , Urb         , Xos         , Xos         , Qxu         , Xos         , Xos         , Ur          , Urb         , Xos         , Urb^Ng/     , Xos         , Urb         , Urb^Ng\     , Xos         , Cud         , Cud         , Cud         , Xos         , Xos         , Xos         
Qlf         , Qlf         , Ql          , Ql          , Qxu         , Xu          , Xu          , Xu          , Xu          , Xos         , Xos         , Urb         , Urb         , Urb         , Urb         , Urb         , Urb         , Urb         , Urb^Ng/     , Xos         , Urb         , Urb         , Xos         , Xos         , Ydc         , Xos         , Xos         , Xos         , Urb         , Urb         , Urb         , Urb         , Urb         , Xol         , Xol         , Xos         , Xos         , Xos         , Xos         
Xu          , Xu          , Xu          , Xu          , Qlf         , Qlf         , Uu          , Xu          , Xu          , Xu          , Xu          , Xos         , Xos         , Urb         , Urb         , Urb         , Xol         , Xol         , Urb         , Urb         , Urb         , Xos         , Urb         , Urb         , Xos         , Xos         , Ydc         , Xos         , Xos         , Urb         , Urb         , Ur          , Ur          , Ur          , Urb         , Xos         , Urb         , Xos         , Xos         
Xu          , Xu          , Qxu         , Qxu         , Xu          , Qlf         , Ur          , Uu          , Xu          , Xu          , Xos         , Xu          , Xos         , Xos         , Xos         , Xos         , Ur          , Urb         , Xos         , Urb         , Urb         , Urb         , Urb         , Xos         , Urb         , Urb         , Xos         , Xos         , Ydc         , Xos         , Xos         , Xos         , Ur          , Urb         , Urb         , Urb         , Urb         , Urb         , Xos         
Xu          , Xos         , Qxu         , Xu          , Xu          , Qxu         , Qxu         , Ur          , Xos         , Xos         , Xos         , Xos         , Xos         , Xos         , Urb         , Ur^Ng\      , Xos         , Xos         , Cud         , Urb         , Xos         , Urb         , Urb         , Urb         , Urb         , Xos         , Urb         , Urb         , Xos         , Xos         , Ur          , Urb         , Xos         , Xos         , Xos         , Urb         , Xos         , Xos         , Xos         
Xu          , Xos         , Xos         , Qxu         , Qxu         , Qxu         , Qxu         , Xos         , Xos         , Xos         , Urb         , Ur          , Ur          , Xos         , Ur          , Ur          , Ur          , Xos         , Xos         , Xos         , Ur          , Ur          , Xos         , Urb         , Urb         , Urb         , Urb         , Xos         , Urb^Ng\     , Ur          , Xos         , Xos         , Ql          , Xos         , Xos         , Xos         , Xos         , Xos         , Xos         
Xu          , Xos         , Xos         , Qxu         , Qxu         , Qxu         , Xos         , Xos         , Xol         , Xol         , Ur          , Ur          , Ur          , Xol         , Xol         , Urb         , Ur          , Urb         , Xos         , Cud         , Xos         , Xos         , Urb         , Xos         , Urb^Ng\     , Urb         , Urb         , Urb         , Urb^Ng/     , Xos         , Ql          , Ql          , Urb         , Ql          , Ql          , Xos         , Xos         , Xos         , Xos         
Xu          , Xu          , Qxu         , Qxu         , Xos         , Xos         , Ydc         , Ydc         , Urb         , Urb         , Urb         , Urb         , Urb         , Urb         , Urb         , Ur          , Urb         , Xos         , Xos         , Xos         , Urb         , Urb         , Urb         , Urb         , Urb         , Urb^Ng\     , Xos         , Urb^Ng/     , Ur          , Urb^Bzn     , Urb         , Urb         , Ur          , Urb         , Ur          , Ql          , Ql          , Xos         , Xos         
Qxu         , Qxu         , Xos         , Xos         , Xos         , Ydc         , Ydk         , Ydc         , Ydc         , Urb         , Urb         , Urb         , Urb         , Urb         , Urb         , Urb         , Xos         , Xos         , Xos         , Urb         , Urb         , Urb         , Urb         , Urb         , Xos         , Xos         , Ql          , Urb^Bzn     , Ur          , Urb         , Urb         , Urb         , Urb         , Ur          , Urb         , Urb         , Ql          , Ql          , Xos         
Qxu         , Xu          , Xu          , Xos         , Xos         , Ydc         , Ydc         , Ydc         , Xos         , Ur^Bzn      , Urb         , Urb         , Urb^Ng/     , Xos         , Xos         , Xos         , Xos         , Xos         , Xos         , Urb         , Urb         , Urb         , Urb         , Xos         , Ql          , Ql          , Urb         , Urb         , Urb         , Ur          , Urb         , 1 Urb       , Urb         , Urb         , Ql          , Ql          , Xos         , Xos         , Xos         
Qxu         , Xu          , Xu          , Xos         , Xos         , Xos         , Ql          , Ydc         , Xos         , Xos         , Xos         , Urb^Ng/     , Urb         , Urb         , Xos         , Xos         , Urb         , Xol         , Xol         , Xos         , Xos         , Urb         , Xos         , Xos         , Xos         , Ql          , Ql          , Urb         , Ur          , Urb         , Urb         , Urb         , Ql          , Ql          , Xos         , Xos         , Xos         , Xos         , Xos         
Xu          , Qxu         , Xu          , Xos         , Xos         , Ql          , Xos         , Xos         , Urb         , Urb         , Ur          , Urb         , Urb         , Urb         , Urb         , Urb         , Urb         , Urb         , Xos         , Xos         , Xol         , Xos         , Xos         , Xos         , Xos         , Xos         , Xos         , Ql          , Ql^Bs/      , Ur          , Ql^Bs\      , Ql          , Xos         , Xos         , Ur          , Xos         , Xos         , Xos         , Xos         
Xu          , Qxu         , Xuc         , Xos         , Ql          , Ql          , Xos         , Xos         , Xos         , Ur          , Ur          , Urb         , Xos         , Urb         , Urb         , Ur          , Ur          , Urb         , Urb^Ng/     , Xos         , Xos         , Xos         , Xos         , Xos         , Ur          , Urb         , Urb         , Urb         , Urb         , Ql          , Urb         , Urb         , Urb         , Urb         , Urb         , Urb         , Urb         , Xos         , Xos         
Qxu         , Qxu         , Qlf         , Qlf         , Ql          , Ql          , Xos         , Xos         , Xos         , Xos         , Xos         , Xos         , Ur          , Urb         , Urb         , Urb         , Xos         , Xos         , Xos         , Urb         , Urb         , Xos         , Xos         , Urb         , Ur          , Ur          , Urb         , Urb         , Urb         , Xos         , Xos         , Ur          , Xos         , Urb         , Urb         , Urb         , Urb         , Urb         , Xos         
Qxu         , Qxu         , Qxu         , Qxu         , Qxu         , Xuc         , Xuc         , Xos         , Qxu         , Xos         , Xos         , Urb         , Urb         , Urb         , Urb         , Xos         , Xos         , Xos         , Ur          , Ygl         , Urb         , Xos         , Xos         , Xos         , Xos         , Urb         , Urb         , Urb         , Urb         , Ur          , Xos         , Xos         , Ur          , Urb         , Ur          , Urb         , Xos         , Xos         , Xos         
Xos         , Qxu         , Xos         , Xos         , Xos         , Qxu         , Qxu         , Qxu         , Qxu         , Qxu         , Uu^Ng/      , Xos         , Qxu         , Urb         , Xos         , Xos         , Xos         , Ygl         , Ygl         , Ur          , Ygl         , Xos         , Xos         , Xos         , Xos         , Xos         , Xos         , Urb         , Xos         , Xos         , Urb         , Urb         , Urb         , Ur          , Urb         , Urb         , Xos         , Xos         , Xos         
Xos         , Xos         , Xos         , Xos         , Xos         , Xos         , Xos         , Xos         , Xos         , Xos         , Xos         , Qxu         , Qxu         , Qxu         , Uu^Ng/      , Xos         , Qxu         , Ygl         , Ygl         , Ur          , Ygl         , Xos         , Xos         , Xos         , Xos         , Xos         , Xos         , Xos         , Xos         , Xos         , Xos         , Urb         , Urb         , Ur          , Ur          , Urb         , Xos         , Xos         , Xos         
Xos         , Xos         , Xos         , Xos         , Xos         , Xos         , Xos         , Xos         , Xos         , Xos         , Xos         , Xos         , Xos         , Xos         , Xos         , Qxu         , Qxu         , Urb         , Ygl         , Ygl         , Ygl         , Xos         , Xos         , Xos         , Xos         , Xos         , Xos         , Xos         , Xos         , Xos         , Xos         , Xos         , Xos         , Urb         , Xos         , Xos         , Xos         , Xos         , Xos         
Xos         , Xos         , Xos         , Xos         , Xos         , Xos         , Xos         , Xos         , Xos         , Xos         , Xos         , Xos         , Xos         , Xos         , Xos         , Xos         , Xos         , Ygl         , Urb         , Ygl         , Urb         , Xos         , Xos         , Xos         , Xos         , Xos         , Xos         , Xos         , Xos         , Xos         , Xos         , Xos         , Xos         , Xos         , Xos         , Xos         , Xos         , Xos         , Xos         
