border_size=1
usage=map

Xu          , Xu          , Xu          , Xu          , Xu          , Xu          , Xu          , Xu          , Xu          , Xu          , Xu          , Xu          , Xu          , Qxu         , Qxu         , Urb         , Urb         , Urb         , Urb         , Urb         , Urb         , Xos         , Xol         , Xu          , Xu          , Xu          , Xu          , Xu          , Xu          , Xu          , Xu          , Xu          , Xu          , Xu          , Xu          , Xu          , Xu          , Xu          , Xu          
Xu          , Xu          , Xu          , Xu          , Xu          , Xu          , Xu          , Xu          , Xu          , Xu          , Xu          , Xu          , Xu          , Qxu         , Qxu         , Qxu         , Xu          , Urb         , Urb         , Urb         , Urb         , Urb         , Urb         , Xol         , Xos         , Xu          , Xu          , Xu          , Xu          , Xu          , Xu          , Xu          , Xu          , Xu          , Xu          , Xu          , Xu          , Xu          , Xu          
Xu          , Xu          , Xu          , Xu          , Xu          , Xu          , Xu          , Xu          , Xu          , Xu          , Xu          , Xu          , Xu          , Xu          , Xu          , Xu          , Xos         , Xu          , Xu          , Ur          , Ur          , Urb         , Urb         , Urb         , Xos         , Xos         , Xos         , Xu          , Xu          , Xu          , Xu          , Xu          , Xu          , Xu          , Xu          , Xu          , Xu          , Xu          , Xu          
Xu          , Xos         , Xos         , Xu          , Xos         , Xu          , Xu          , Xu          , Xu          , Xu          , Xu          , Xu          , Xu          , Xu          , Xu          , Xu          , Xu          , Xos         , Xos         , Xos         , Xos         , Urb         , Urb         , Urb         , Xos         , Xos         , Xos         , Xu          , Xu          , Xu          , Xu          , Xu          , Xu          , Xu          , Xu          , Xu          , Xu          , Xu          , Xu          
Xos         , Xos         , Xos         , Xos         , Xos         , Xos         , Xos         , Xu          , Xos         , Xu          , Xu          , Xu          , Xos         , Xu          , Xos         , Xu          , Xu          , Xu          , Xu          , Xos         , Xos         , Urb         , Urb         , Urb         , Xos         , Xos         , Xos         , Xu          , Xu          , Xu          , Xu          , Xu          , Xu          , Xu          , Xu          , Xu          , Xu          , Xu          , Xu          
Xos         , Xos         , Urb         , Ur          , Urb         , Xos         , Xos         , Xos         , Xol         , Xos         , Xol         , Xol         , Ur          , Xol         , Cud         , Xos         , Xos         , Xos         , Xos         , Xos         , Xos         , Urb         , Urb         , Urb         , Xos         , Xos         , Xu          , Xu          , Xu          , Xu          , Xos         , Xu          , Xos         , Xu          , Xu          , Xu          , Xu          , Xu          , Xu          
Xos         , Urb         , Urb         , Urb         , Urb^Ng/     , Xos         , Xol         , Xos         , Ur          , Ur          , Ql          , Ql          , Urb         , Urb         , Cud         , Cud         , 3 Kud       , Cud         , Xos         , Xos         , Xos         , Urb         , Urb         , Urb         , Xol         , Xos         , Xos         , Xos         , Xos         , Xos         , Xos         , Xos         , Xos         , Xos         , Xos         , Xu          , Xu          , Xu          , Xu          
Xu          , Xos         , Xos         , Xos         , Ur          , Urb         , Urb         , Xol         , Xos         , Urb         , Urb         , Urb         , Urb         , Urb         , Urb         , Cud         , Cud         , Cud         , Xos         , Xos         , Ur          , Ur^Ng\      , Xos         , Ur^Ng/      , Ur          , Xos         , Xos         , Xos         , Xos         , Xos         , Urb         , Xos         , Xos         , Xos         , Xos         , Xos         , Xos         , Xu          , Xu          
Xu          , Xos         , Urb         , Ur          , Urb         , Urb         , Urb         , Ur          , Ur          , Xos         , Urb         , Urb         , Urb         , Urb         , Urb^Bzl     , Urb         , Cud         , Qxu         , Xos         , Xos         , Urb         , Urb^Bzl     , Ur          , Urb^Bzl     , Urb         , Xos         , Xos         , Xos         , Urb         , Urb         , Urb         , Ur          , Xos         , Xos         , Ql          , Xos         , Xos         , Xu          , Xos         
Xos         , Xos         , Urb         , Urb         , Urb         , Urb         , Xos         , Ur          , Ur          , Urb         , Urb         , Urb         , Xol         , Xos         , Xos         , Cud         , Cud         , Qxu         , Xol         , Xos         , Urb         , Urb         , Ur          , Urb         , Urb         , Xos         , Xos         , Xos         , Urb         , Urb         , Ur          , Ur          , Xos         , Ql          , Xol         , Qxu         , Qxu         , Xos         , Xos         
Xos         , Xos         , Urb^Ng\     , Urb         , Xos         , Xos         , Xuc         , Xos         , Xos         , Urb         , Urb         , Urb         , Urb         , Xol         , Xos         , Cud         , Xos         , Xol         , Urb         , Urb         , Ur          , Ur          , Urb         , Urb         , Xos         , Xos         , Urb         , Xos         , Xos         , Urb         , Urb         , Xos         , Urb         , Ur          , Ur          , Xol         , Xos         , Ql          , Ql          
Ygl         , Ygl         , Ygl         , Xuc         , Xuc         , Xuc         , Uu^Nsh      , Xuc         , Xos         , Xos         , Urb         , Urb         , Urb         , Urb         , Xol         , Xol         , Cud         , Urb         , Urb         , Urb         , Urb         , Urb         , Xos         , Xos         , Xos         , Urb         , Urb         , Urb         , Urb         , Urb         , Urb         , Urb         , Urb         , Urb         , Xos         , Xos         , Xos         , Xos         , Qxu         
Ygl         , Ygl         , Xuc         , Xuc         , Uu          , Uu          , Xuc         , Uu^Dr       , Ur          , Ur          , Ur          , Urb         , Xol         , Xos         , Qxu         , Cud         , Cud         , Cud         , Cud         , Urb         , Xos         , Xos         , Xos         , Xos         , Xos         , Xos         , Xos         , Urb         , Urb         , Urb         , Urb         , Urb         , Urb         , Xos         , Xol         , Xol         , Qxu         , Qxu         , Xos         
Xuc         , Xuc         , Ql          , Xu          , Uu          , Xuc         , Xos         , Xos         , Urb         , Urb         , Xos         , Xol         , Qxu         , Qxu         , Ur          , Ur          , Qxu         , Cud         , Xos         , Xol         , Xos         , Xos         , Xos         , Xos         , Xos         , Xos         , Xos         , Urb         , Ur          , Urb         , Xos         , Urb         , Urb^Ng/     , Urb^Ng/     , Urb         , Urb         , Urb         , Xos         , Xos         
Xu          , Xu          , Ql          , Uu          , Qxu         , Qxu         , Qxu         , Xos         , Urb         , Urb         , Xos         , Qxu         , Urb         , Urb         , Qxu         , Qxu         , Xos         , Xos         , Xos         , Xos         , Xos         , Xos         , Xos         , Xos         , Xos         , Xos         , Xos         , Xos         , Xos         , Xos         , Urb         , Xos         , Urb         , Ur          , Urb         , Urb         , Urb         , Urb         , Xos         
Qlf         , Qlf         , Xu          , Ql          , Ql          , Ql          , Qlf         , Qlf         , Urb         , Ur          , Ur          , Urb^Ng\     , Urb^Ng\     , Qxu         , Xol         , Xos         , Cud         , Cud         , 2 Kud       , Cud         , Cud         , Xos         , Xos         , Xos         , Xos         , Xos         , Urb         , Xos         , Xos         , Urb         , Urb         , Ur          , Ur          , Ur          , Ur          , Urb         , Cud         , Urb         , Xos         
Ql          , Xu          , Xu          , Xu          , Ql          , Ql          , Ql          , Qxu         , Qlf         , Ur          , Urb         , Urb         , Urb         , Xol         , Xol         , Xol         , Urb         , Cud         , Cud         , Qxu         , Cud         , Xos         , Xos         , Xos         , Xos         , Urb         , Urb         , Urb         , Xol         , Urb         , Urb         , Ur          , Urb         , Ur          , Cud         , Urb^Bzn     , Kud         , Cud         , Xos         
Xu          , Xu          , Qxu         , Qlf         , Qxu         , Ql          , Xuc         , Qlf         , Xos         , Urb         , Urb         , Urb         , Urb         , Ur          , Ur          , Ur          , Ur          , Urb^Bzl     , Ydc         , Cud         , Xos         , Xos         , Xos         , Xos         , Ur          , Urb         , Ur          , Urb         , Urb         , Xol         , Urb^Ng\     , Urb         , Xos         , Cud         , Qxu         , Cud         , Cud         , Cud         , Xos         
Qlf         , Xu          , Ql          , Qxu         , Qlf         , Xu          , Xu          , Xuc         , Xuc         , Xos         , Urb         , Urb         , Urb         , Urb         , Urb         , Urb         , Urb         , Urb         , Urb         , Ydc         , Xol         , Xos         , Urb         , Urb^Ng\     , Xos^Zos     , Xos         , Xos^Zos     , Urb         , Urb         , Urb         , Urb         , Urb^Ng\     , Xos         , Cud         , Cud         , Cud         , Xos         , Xos         , Xos         
Qlf         , Qlf         , Ql          , Ql          , Qxu         , Xu          , Xu          , Xu          , Xu          , Xos         , Xos         , Urb         , Urb         , Urb         , Urb         , Urb         , Urb         , Urb         , Urb^Ngl/    , Xol         , Urb         , Urb         , Xos         , Xos         , Qxu         , Qxu^Zos     , Qxu^Zos     , Xos^Zos     , Xos^Zos     , Urb         , Urb         , Urb         , Urb         , Xol         , Xol         , Xos         , Xos         , Xos         , Xos         
Xu          , Xu          , Xu          , Xu          , Qlf         , Qlf         , Uu          , Xu          , Xu          , Xu          , Xu          , Xos         , Xos         , Urb         , Urb         , Urb         , Xol         , Urb^Ngl/    , Urb         , Urb         , Urb         , Xos         , Urb         , Cud         , Cud         , Qxu         , Qxu         , Qxu^Zos     , Qxu^Zos     , Xos^Zos     , Xos^Zos     , Ur          , Ur          , Ur          , Urb         , Xos         , Urb         , Xos         , Xos         
Xu          , Xu          , Qxu         , Qxu         , Xu          , Qlf         , Ur          , Uu          , Xu          , Xu          , Xos         , Xu          , Xos         , Xos         , Xos         , Xol         , Ur          , Urb         , Xos         , Urb         , Urb         , Urb         , Urb         , Urb         , Urb         , Cud         , Cud         , Qxu         , Qxu         , Qxu^Zos     , Qxu^Zos     , Xos^Zos     , Xos         , Urb         , Urb         , Urb         , Urb         , Urb         , Xos         
Xu          , Xos         , Qxu         , Xu          , Xu          , Qxu         , Qxu         , Ur          , Xos         , Xos         , Xos         , Xos         , Xos         , Xos         , Urb         , Ur^Ng\      , Xos         , Xos^Zos     , Qxu^Zos     , Qxu         , Qxu         , Urb         , Urb         , Urb         , Urb         , Urb         , Urb         , Cud         , Cud         , Qxu         , Xos         , Xos         , Xos         , Urb         , Urb         , Ur          , Xos         , Xos         , Xos         
Xu          , Xos         , Xos         , Qxu         , Qxu         , Qxu         , Qxu         , Xos         , Xos         , Xos         , Urb         , Ur          , Ur          , Xos         , Ur          , Ur          , Ur          , Xos         , Xos         , Qxu^Zos     , Qxu^Zos     , Qxu         , Xos         , Urb         , Urb         , Urb         , Urb         , Urb         , Xos         , Xos         , Xos         , Xos         , Ql          , Xos         , Xos         , Urb         , Xos         , Xos         , Xos         
Xu          , Xos         , Xos         , Qxu         , Qxu         , Qxu         , Xos         , Xos         , Xol         , Xol         , Ur          , Ur          , Ur          , Xol         , Xol         , Urb         , Ur          , Urb         , Xos         , Xos         , Xos         , Xos         , Urb         , Xos         , Urb^Ng\     , Urb         , Urb         , Urb         , Urb^Ng/     , Xos         , Ql          , Ql          , Urb         , Ql          , Ql          , Xos         , Xos         , Xos         , Xos         
Xu          , Xu          , Qxu         , Qxu         , Xos         , Xos         , Ydc         , Ydc         , Urb         , Urb         , Urb         , Urb         , Urb         , Urb         , Urb         , Ur          , Urb         , Xos         , Xos         , Xos         , Urb         , Urb         , Urb         , Urb         , Urb         , Urb^Ng\     , Xos         , Urb^Ng/     , Ur          , Urb^Bzn     , Urb         , Urb         , Ur          , Urb         , Ur          , Ql          , Ql          , Xos         , Xos         
Qxu         , Qxu         , Xos         , Xos         , Xos         , Ydc         , Ydk         , Ydc         , Ydc         , Urb         , Urb         , Urb         , Urb         , Urb         , Urb         , Urb         , Xos         , Xos         , Xos         , Urb         , Urb         , Urb         , Urb         , Urb         , Xos         , Xos         , Ql          , Urb^Bzn     , Ur          , Urb         , Urb         , Urb         , Urb         , Ur          , Urb         , Urb         , Ql          , Ql          , Xos         
Qxu         , Xu          , Xu          , Xos         , Xos         , Ydc         , Ydc         , Ydc         , Xos         , Ur^Bzn      , Urb         , Urb         , Urb^Ng/     , Xos         , Xos         , Xos         , Xos         , Xos         , Xos         , Urb         , Urb         , Urb         , Urb         , Xos         , Ql          , Ql          , Urb         , Urb         , Urb         , Ur          , Urb         , 1 Urb       , Urb         , Urb         , Ql          , Ql          , Xos         , Xos         , Xos         
Qxu         , Xu          , Xu          , Xos         , Xos         , Xos         , Ql          , Ydc         , Xos         , Xos         , Xos         , Urb^Ng/     , Urb         , Urb         , Xos         , Xos         , Urb         , Xol         , Xol         , Xos         , Xos         , Urb         , Xos         , Xos         , Xos         , Ql          , Ql          , Urb         , Ur          , Urb         , Urb         , Urb         , Ql          , Ql          , Xos         , Xos         , Xos         , Xos         , Xos         
Xu          , Qxu         , Xu          , Xos         , Xos         , Ql          , Xos         , Xos         , Urb         , Urb         , Ur          , Urb         , Urb         , Urb         , Urb         , Urb         , Urb         , Urb         , Urb         , Xos         , Xol         , Xos         , Xos         , Xos         , Xos         , Xos         , Xos         , Ql          , Ql^Bs/      , Ur          , Ql^Bs\      , Ql          , Xos         , Xos         , Ur          , Xos         , Xos         , Xos         , Xos         
Xu          , Qxu         , Xuc         , Xos         , Ql          , Ql          , Xos         , Xos         , Xos         , Ur          , Ur          , Urb         , Xos         , Urb         , Urb         , Ur          , Ur          , Urb         , Xos         , Xos         , Xos         , Xos         , Xos         , Xos         , Ur          , Urb         , Urb         , Urb         , Urb         , Ql          , Urb         , Urb         , Urb         , Urb         , Urb         , Urb         , Urb         , Xos         , Xos         
Qxu         , Qxu         , Qlf         , Qlf         , Ql          , Ql          , Xos         , Xos         , Xos         , Xos         , Xos         , Xos         , Ur          , Urb         , Urb         , Urb         , Xos         , Xos         , Xu          , Xos         , Xu          , Xos         , Xos         , Urb         , Ur          , Ur          , Urb         , Urb         , Urb         , Xos         , Xos         , Ur          , Xos         , Urb         , Urb         , Urb         , Urb         , Urb         , Xos         
Qxu         , Qxu         , Qxu         , Qxu         , Qxu         , Xuc         , Xuc         , Xos         , Qxu         , Xos         , Xos         , Urb         , Urb         , Urb         , Urb         , Xos         , Xos         , Xos         , Xu          , Xu          , Xu          , Xos         , Xu          , Xos         , Xos         , Urb         , Urb         , Urb         , Urb         , Ur          , Xos         , Xos         , Ur          , Urb         , Ur          , Urb         , Xos         , Xos         , Xos         
Xos         , Qxu         , Xos         , Xos         , Xos         , Qxu         , Qxu         , Qxu         , Qxu         , Qxu         , Uu^Ngl/     , Xos         , Qxu         , Urb         , Xos         , Xos         , Xu          , Xu          , Xu          , Xu          , Xu          , Xu          , Xu          , Xu          , Xu          , Xos         , Xos         , Urb         , Xos         , Xos         , Urb         , Urb         , Urb         , Ur          , Urb         , Urb         , Xos         , Xos         , Xos         
Xu          , Xos         , Xu          , Xos         , Xos         , Xos         , Xos         , Xu          , Xu          , Xos         , Xos         , Qxu         , Qxu         , Qxu         , Uu^Ngl/     , Xos         , Qxu         , Xu          , Xu          , Xu          , Xu          , Xu          , Xu          , Xu          , Xu          , Xos         , Xos         , Xos         , Xos         , Xos         , Xos         , Urb         , Urb         , Ur          , Ur          , Urb         , Xos         , Xos         , Xos         
Xu          , Xu          , Xu          , Xu          , Xu          , Xu          , Xu          , Xu          , Xu          , Xu          , Xu          , Xos         , Xos         , Xos         , Xos         , Qxu         , Qxu         , Uu          , Xu          , Xu          , Xu          , Xu          , Xu          , Xu          , Xu          , Xu          , Xu          , Xos         , Xu          , Xu          , Xu          , Xos         , Xos         , Urb         , Xos         , Xos         , Xos         , Xos         , Xos         
Xu          , Xu          , Xu          , Xu          , Xu          , Xu          , Xu          , Xu          , Xu          , Xu          , Xu          , Xu          , Xu          , Xu          , Xos         , Xos         , Qxu         , Uu          , Uu          , Xu          , Xu          , Xu          , Xu          , Xu          , Xu          , Xu          , Xu          , Xu          , Xu          , Xu          , Xu          , Xu          , Xos         , Xos         , Xos         , Xos         , Xos         , Xos         , Xos         
