border_size=1
usage=map

Mm          , Mm^Xm       , Mm^Xm       , Mm          , Mm^Xm       , Mm          , Wog         , Wog         , Ss          , Wog         , Ss          , Mm          , Mm^Xm       , Mm^Xm       , Mm^Xm       , Mm          , Mm          , Mm          , Mm          , Mm^Xm       , Mm          , Mm          , Mm^Xm       , Mm          , Mm          , Mm          , Mm^Xm       , Mm          , Mm          , Mm          , Mm^Xm       , Mm^Xm       , Mm^Xm       , Mm          , Mm^Xm       , Mm          , Mm^Xm       , Xu          , Xu          , Xu          , Xu          , Xu          , Xu          , Xu          , Xu          , Xu          
Mm^Xm       , Mm          , Mm^Xm       , Mm^Xm       , Mm          , Mm          , Sm          , Sm          , Wog         , Wog         , Sm          , Wog         , Mm          , Mm^Xm       , Mm          , Mm          , Mm          , Mm^Xm       , Mm          , Mm^Xm       , Mm          , Mm^Xm       , Mm          , Mm          , Mm          , Mm          , Mm          , Mm^Xm       , Mm          , Mm          , Mm          , Mm          , Mm^Xm       , Mm^Xm       , Mm          , Mm          , Xu          , Xu          , Uh          , Xu          , Xu          , Xu          , Hhd         , Xu          , Xu          , Xu          
Mm          , Mm          , Mm          , Mm          , Mm          , Hh          , Ds          , Ss          , Ss          , Wog         , Ss          , Ds          , Ss          , Mm          , Hh          , Mm^Xm       , Mm          , Mm          , Mm          , Mm          , Mm^Xm       , Mm          , Mm          , Mm^Xm       , Mm          , Hhd         , Hhd         , Mm          , Hh          , Hhd         , Mm          , Mm          , Mm          , Mm^Xm       , Mm          , Mm          , Xu          , Xu          , Xu          , Uh^Uf       , Uue         , Uh^Uf       , Rb^Uf       , Hhd         , Xu          , Xu          
Mm          , Mm^Xm       , Mm^Xm       , Mm          , Hh          , Ds          , Ss          , Wog         , Ss          , Ss          , Wog         , Ss          , Ss          , Ss          , Wog         , Hh          , Ss          , Hh          , Mm          , Mm^Xm       , Mm          , Mm^Xm       , Mm          , Mm^Xm       , Mm          , Mm          , Mm          , Hh          , Hhd^Es      , Hh          , Hh          , Mm          , Mm          , Mm          , Hhd         , Hh          , Uu^Dr       , Uu^Uf       , Rb          , Uue^Uf      , Uu          , Uue^Emf     , Rb          , Uh          , Xu          , Xu          
Mm          , Mm          , Mm          , Mm          , Hhd         , Wog         , Wog         , Wog         , Ss          , Ss          , Ss          , Wog         , Wog         , Wog         , Ss          , Ss          , Hh          , Hh          , Mm          , Mm^Xm       , Mm          , Mm          , Mm          , Mm          , Hhd         , Hhd         , Hhd         , Hh          , Hhd         , Hh          , Hhd         , Gd          , Gd          , Mm          , Gd          , Hhd         , Rb          , Uu          , Uu          , Rb          , Rb          , Uue^Uf      , Uh          , Hhd         , Xu          , Xu          
Mm          , Mm          , Mm          , Mm          , Hh          , Ss          , Ss          , Ss          , Mm          , Mm          , Ss          , Ss          , Ss          , Wog         , Ss          , Mm          , Mm          , Mm          , Mm          , Mm          , Gd          , Gd          , Hh^Fms      , Hh^Fds      , Hh^Fds      , Hh^Fp       , Gd          , Hh          , Gll^Fp      , Gd          , Gd          , Gd          , Gd          , Gd          , Gd          , Gd          , Hhd         , Uu^Uf       , Uu^Uf       , Uue         , Cud         , Uu          , Xu          , Xu          , Xu          , Xu          
Mm          , Mm          , Hhd         , Mm          , Sm          , Wog         , Wog         , Mm          , Mm^Xm       , Mm          , Mm^Xm       , Mm          , Mm          , Mm          , Mm          , Wog         , Ss          , Mm          , Gs          , Mm          , Gd          , Gd          , Gd          , Gs^Fms      , Gd^Fmf      , Gs^Fms      , Gll^Fp      , Gll^Fp      , Gll^Fp      , Gll^Fmf     , Gll^Fp      , Gg^Fms      , Gg^Fms      , Gd          , Gd          , Hhd         , Hh          , Xu          , Xu          , Cud         , 3 Kud       , Cud         , Cud         , Uu          , Xu          , Xu          
Mm          , Hh          , Mm          , Hhd         , Hh          , Hh          , Wog         , Mm          , Mm          , Mm^Xm       , Mm^Xm       , Mm^Xm       , Mm          , Mm          , Wog         , Wog         , Gll^Fp      , Gs          , Gll^Fp      , Gd          , Gg^Fdf      , Gs^Fms      , Gs^Fms      , Gd^Fmf      , Gg^Fms      , Gs^Fms      , Gll^Fp      , Gll^Fp      , Gll^Fmf     , Gll^Fmf     , Gg^Fms      , Gg^Fms      , Gg^Fdf      , Gd          , Gd          , Hh          , Mm          , Mm          , Mm          , Xu          , Cud         , Cud         , Uue         , Cud         , Xu          , Xu          
Mm          , Mm          , Hhd         , Hhd         , Hhd         , Sm          , Sm          , Wwrg        , Wwrg        , Mm          , Ss          , Mm^Xm       , Ss          , Ss          , Wog         , Ds^Em       , Gll^Fp      , Gll^Fp      , Gll^Fp      , Gll^Fmf     , Gll^Fmf     , Gs^Fms      , Rd^Fds      , Rd^Fms      , Rd^Fp       , Gs^Fms      , Rd          , Rd          , Rd          , Gll^Fp      , Gg^Fmf      , Gll^Fmf     , Gg^Fdf      , Gd          , Mm          , Mm          , Mm          , Mm          , Mm          , Xu          , Uu^Uf       , Uu          , Uue         , Uh          , Hhd         , Xu          
Gs          , Mm          , Gs          , Gs          , Gs          , Gs          , Gll^Fp      , Sm          , Hh          , Wwrg        , Sm          , Ss          , Ds          , Ss          , Wog         , Gll^Fp      , Gll^Fp      , Gll^Fp      , Gll^Fmf     , Gll^Fmf     , Rd^Fms      , Rd^Fp       , Gs^Fms      , Gs^Fds      , Gll^Fmf     , Rd          , Gd          , Gd          , Gd          , Rd^Fp       , Rd^Fms      , Gg^Fdf      , Gs          , Gd          , Mm          , Hhd         , Hh          , Mm          , Gd          , Uh          , Rb          , Rb          , Uue         , Uue^Uf      , Xu          , Xu          
Gs          , Gs          , Re          , Gs          , Gll^Fp      , Gll^Fp      , Gll^Fp      , Gll^Fp      , Gll^Fp      , Gs^Es       , Re          , Gs          , Gs          , Ds          , Rd          , Wog         , Ss          , Gll^Fp      , Rd          , Rd          , Gd          , Gd          , Gd          , Gs^Fms      , Gd          , Gd          , Gd          , Gd          , Gd          , Gd          , Rd          , Gs          , Rd          , Gs^Efm      , Gd          , Mm          , Hh          , Gd          , Gd          , Rb          , Uu          , Uu^Uf       , Uu          , Uu          , Rb          , Uu          
Gs          , Gs^Es       , Gs          , Re          , Gg          , Gll^Fp      , Gs          , Gg          , Gll^Fp      , Gs          , Gs          , Re          , Re          , Rd          , Gs          , Rd          , Ss^Bw/      , Wog^Bw/     , Ss          , Ss          , Ds          , Gd          , Gd          , Mm          , Mm          , Mm          , Mm          , Gd          , Mm          , Gs          , Hhd         , Rd          , Gs^Es       , Rd          , Rd          , Gd          , Gd          , Gd          , Mm          , Mm          , Xu          , Uue^Uf      , Uh^Vu       , Uh^Uf       , Uh^Dr       , Uu          
Gs^Efm      , Gs^Efm      , Gs^Efm      , Gs          , Gs          , Gg          , Gs          , Gll^Fp      , Gd          , Gs          , Gs          , Gs          , Re          , Gs          , Ds          , Ds          , Ket         , Ds          , Wog         , Ss          , Gs          , Ds          , Ds          , Mm          , Mm          , Mm          , Mm          , Mm          , Mm^Xm       , Hh          , Hh          , Gs^Efm      , Gs^Efm      , Gs^Es       , Rd          , Gd          , Gd          , Mm          , Mm          , Mm^Xm       , Mm^Xm       , Xu          , Xu          , Qxu         , Xu          , Xu          
Gg          , Gs^Efm      , Gg          , Gs^Vct      , Gd          , Gs^Es       , Gd          , Gd          , Gll^Fmf     , Gs          , Gll^Fmf     , Rb          , Rb          , Gs          , Gd          , Ds          , Gs^Es       , Ds          , Ss          , Ss          , Ss          , Ds          , Ds          , Gd          , Ds          , Mm          , Mm          , Mm^Xm       , Mm          , Mm          , Hhd         , Hhd         , Hh          , Gs          , Rd          , Gs^Es       , Hh          , Hh          , Hh          , Mm^Xm       , Mm          , Xu          , Xu          , Xu          , Xu          , Xu          
Gd          , Gd          , Gd          , Gd          , Rb          , Gd          , Qxu         , Rb          , Gd          , Gll^Fmf     , Rb          , Rb          , Gd          , Gd          , Gd          , Rb          , Gd          , Gs          , Gs^Fms      , Wog         , Wog         , Ds          , Ds          , Ds          , Gs^Fp       , Hhd         , Mm          , Mm^Xm       , Mm          , Mm          , Hh          , Mm          , Hh          , Gs          , Rd          , Gs          , Hhd         , Hh          , Hhd         , Mm          , Mm          , Mm^Xm       , Mm          , Xu          , Xu          , Xu          
Gd          , Gd          , Qxu         , Gd          , Qxu^Bw|     , Qxu         , Qxu         , Qxu         , Qxu         , Gd          , Qxu^Bw|     , Qxu         , Qxu         , Gd          , Gd          , Gd          , Rb          , Gs^Fms      , Rb          , Ss          , Wog         , Ss          , Wog         , Sm          , Hhd^Fp      , Hhd^Fp      , Mm          , Mm^Xm       , Mm^Xm       , Mm^Xm       , Mm          , Mm          , Hh          , Gs          , Rd          , Hhd^Es      , Hhd         , Mm          , Mm          , Hhd         , Mm          , Mm^Xm       , Mm^Xm       , Mm^Xm       , Mm          , Xu          
Gd          , Qxu         , Qxu         , Qxu         , Hhd         , Qxu         , Hhd^Fdf     , Hhd         , Qxu         , Qxu         , Hhd         , Qxu         , Gd^Es       , Qxu         , Qxu^Bw|     , Qxu         , Qxu         , Gll^Fmf     , Wog         , Wog         , Ds          , Ss          , Wog         , Sm^Emf      , Sm^Uf       , Hh          , Hh          , Mm          , Mm^Xm       , Mm^Xm       , Mm^Xm       , Hh          , Gs^Efm      , Gs          , Rd          , Gs          , Gs          , Hh          , Gd          , Mm          , Mm          , Mm          , Mm^Xm       , Mm^Xm       , Mm          , Mm^Xm       
Qxu         , Qxu         , Qxu         , Hhd         , Rb          , Hhd^Fdf     , Gd          , Gd^Es       , Rb          , Hhd^Fdf     , Hhd^Fdf     , Hhd         , Hhd         , Gd          , Rb          , Qxu         , Qxu         , Qxu         , Wog         , Wog         , Ss          , Rb          , Ds          , Rb^Uf       , Mm          , Mm          , Mm          , Mm^Xm       , Mm          , Mm          , Hh^Fms      , Gs^Efm      , Gs          , Gs          , Rd^Fp       , Gg^Fp       , Gg^Fp       , Gs          , Mm          , Mm          , Hh          , Mm          , Mm          , Mm          , Mm^Xm       , Mm^Xm       
Qxu         , Qxu         , Qxu         , Hhd^Dr      , Rb^Fdf      , Gd^Fdf      , Gd          , Gd          , Co          , Gd^Fdf      , Gd          , Rb          , Co          , Hhd         , Gd          , Gd          , Rb          , Qxu         , Qxu         , Ss          , Mm          , Ds          , Mm          , Ds          , Mm          , Mm^Xm       , Mm^Xm       , Mm^Xm       , Mm          , Hh^Fms      , Hh^Fp       , Gs^Fms      , Gs          , Gg^Fp       , Gll^Fmf     , Rd^Fms      , Rd^Fds      , Gs          , Gs^Fms      , Hh          , Gd          , Mm          , Hh          , Mm          , Mm          , Mm          
Qxu         , Hh          , Hh          , Hhd         , Gd^Es       , Rb          , Gd          , Co          , Co          , Co          , 2 Ko        , Co          , Co          , Co          , Gd^Es       , Gd^Fdf      , Rb^Fdf      , Qxu         , Qxu         , Qxu         , Mm^Xm       , Mm^Xm       , Mm          , Mm^Xm       , Mm          , Mm          , Mm^Xm       , Mm          , Mm^Xm       , Hhd^Fmf     , Hh^Fp       , Hh          , Gs          , Gg^Fms      , Gs^Fms      , Gll^Fmf     , Rd^Fds      , Gs^Fds      , Gll^Fmf     , Gs^Efm      , Gs^Es       , Gd          , Gs^Fms      , Hh          , Mm^Xm       , Mm^Xm       
Mm          , Hhd         , Hh^Fdf      , Gd^Fdf      , Rb^Fdf      , Rb^Es       , Rb          , Co          , Co          , Co          , Rb          , Co          , Co          , Co          , Rb^Es       , Rb^Es       , Gd^Vct      , Hhd         , Qxu         , Mm^Xm       , Mm^Xm       , Mm          , Mm^Xm       , Mm          , Mm^Xm       , Mm^Xm       , Mm          , Mm^Xm       , Mm^Xm       , Mm          , Mm          , Gs^Es       , Gs^Es       , Gs^Es       , Gs^Fds      , Gg^Fms      , Gll^Fp      , Rd          , Rd          , Gs^Es       , Rd          , Gs^Es       , Hhd^Fmf     , Hhd^Fdf     , Mm          , Mm          
Mm          , Hhd         , Hh          , Hh          , Hhd         , Hhd         , Gd          , Gd          , Gd          , Hhd         , Rb          , Gd          , Gd          , Gd^Fdf      , Gd          , Rb          , Hh          , Hhd         , Qxu         , Qxu         , Mm^Xm       , Mm          , Mm          , Mm          , Mm^Xm       , Mm^Xm       , Mm^Xm       , Mm          , Hh          , Hh          , Gd          , Gs^Efm      , Hh          , Gll^Fmf     , Hhd^Fmf     , Gs^Fms      , Hh^Fds      , Gs^Efm      , Gs          , Rd          , Rd          , Rd          , Gll^Fp      , Hhd^Fdf     , Hh          , Mm          
Mm          , Mm          , Mm          , Hh          , Hhd         , Hhd^Dr      , Hh^Fdf      , Hhd^Fdf     , Hh          , Hhd         , Hhd^Es      , Rb          , Rb          , Rb^Fdf      , Hh^Fdf      , Hhd^Fdf     , Hh          , Hh          , Hh          , Qxu         , Mm^Xm       , Mm          , Mm^Xm       , Mm^Xm       , Mm          , Mm          , Mm          , Hh          , Mm          , Hh          , Gd          , Gs          , Mm          , Hh          , Hhd^Fdf     , Hhd^Fdf     , Hh^Fms      , Gs^Efm      , Hh          , Gd          , Gs          , 1 Rd        , Gs          , Gll^Fp      , Gs          , Hh          
Mm          , Mm          , Mm          , Mm          , Hh          , Mm          , Mm          , Hhd         , Mm          , Hhd         , Mm          , Hhd^Fdf     , Hhd         , Hhd^Fdf     , Hh          , Hhd         , Mm          , Mm          , Mm          , Mm^Xm       , Mm          , Mm          , Mm          , Mm^Xm       , Mm^Xm       , Mm          , Mm^Xm       , Mm          , Mm          , Gd          , Gd          , Gd          , Mm          , Mm          , Mm          , Hh^Fds      , Mm          , Hhd^Fmf     , Hh          , Gd          , Gs          , Rd          , Rd          , Gs          , Gs          , Gs          
Mm          , Mm          , Mm          , Mm          , Mm          , Mm          , Mm          , Mm          , Mm          , Mm          , Mm          , Mm          , Mm          , Hh          , Mm          , Mm          , Mm          , Mm          , Mm^Xm       , Mm^Xm       , Mm^Xm       , Mm^Xm       , Mm^Xm       , Mm^Xm       , Mm^Xm       , Mm          , Mm          , Mm^Xm       , Mm^Xm       , Mm^Xm       , Mm          , Mm          , Mm          , Mm          , Mm          , Mm          , Mm          , Mm          , Hh          , Hh          , Gs          , Gs          , Gs          , Rd          , Rd          , Gs          
